#############################
#############################
#%         	          ##$$$$#
#                    ########
#                $      #####
#    $          $#$         #
#   $#$        #####        #
#  #####                    #
#              #####$$$$#####
#   #####      ###########  #
#   #$$$#      #$$$$$$###   #
#   #####      #########    #
#    $         #######      #
#   $#$                     #
#  #####                    #
#                           #
#            $  $  $  $     #
#            #  #  #  #     #
#              @            #
#  ################$        #
#   ##################      #
#                           #
#############################