###################
###$##@     ###@###
#$######### #$# ###
########### ### ###
%               ###
###################